10,10,10,10,10,0,0,0,0,0,0
9,10,10,9,8,2,2,0,4,3,0
8,9,9,7,8,1,1,3,4,2,0
7,8,8,8,7,2,2,3,1,2,0
7,7,8,6,7,0,0,2,1,0,0
0,1,2,0,2,3,2,0,1,0,0
6,6,7,5,6,0,6,7,8,7,8
6,7,4,7,6,0,8,8,9,7,7
7,5,7,5,7,1,9,7,8,7,6
5,4,6,3,4,2,9,8,10,9,10
6,6,5,5,5,3,10,10,10,10,10